30000000010044400013
01110101001311111010
01310101100100001010
01410100110101101010
01010100010101141010
01410101410041101010
01000100011101101010
01100111000101301014
00010001110101111010
01001000015100000014
00101410001311111010
14101001111010001110
00131001000010100100
01113101411110010141
00000001000001010100
11010101111101010110
00010101030101410100
01000100010001310101
01111111111111110100
00000000000000000000

1:wall
3:coin
4:trap
5:hole