34011011010000010011
01000000030101011300
11111111101111000010
04444000000001111110
01110111110100000000
00000111010001100010
11100003001100010000
14340111111001001001
00410000010010100310
01001111410100011100
01151011110111010011
00010000000001100000
31000010141100001010
01111000101111111010
01000011100011101110
41111111101030010000
00000000001001000100
11111411111101111010
00003000001111003000
01111111100000110110

1:wall
3:coin
4:trap
5:hole